
#Oggetti interagibili

#A-Z
Access terminal : [E]=Accéder au terminal : [E]
Beam up : [E]=Téléporter : [E]
Change: Green suit=Se changer : Combi. Verte
Charge item : [E]=Recharger : [E]
Climb : [E]=Grimper : [E]
Close door : [E]=Fermer la porte : [E]
Confirm: [B]   |   Rotate: [R]   |   Store: [X]=Confirmer : [B]  |   Tourner : [R]  |   Stocker : [X]
Disable speaker: [E]=Éteindre le haut-parleur : [E]
Enter : [E]=Entrer : [E]
Enter: [E]=Entrer: [E]
Exit : [E]=Sortir : [E]
Flip switch: [E]=Interrupteur : [E]
Flush: [E]=Tirer la chasse : [E]
Get log : [E]=Prendre le journal : [E]
Grab : [E]=Saisir : [E]
Hit pumpkin : [E]=Frapper la citrouille : [E]
Land ship : [E]=Atterrir : [E]
Let go : [E]=Lâcher : [E]
Lift glass : [E]=Lever la vitre : [E]
Open : [E]=Ouvrir : [E]
Open door : [E]=Ouvrir la porte : [E]
Open Gift : [E]=Ouvrir le cadeau : [E]
Open hatch : [E]=Ouvrir trappe : [E]
Open: [E]=Ouvrir : [E]
Play record: [E]=Lire le disque : [E]
Pull cord: [E] (Hold)=Tirer : [E](Maintenir)
Pull valve : [E]=Fermer la vanne : [E]
Quit terminal : [TAB]=Quitter le terminal : [TAB]
Ring bell: [E]=Faire sonner : [E]
Scan : [RMB]=Scanner : [Clic droit]
Sell item : [E]=Vendre l'objet : [E]
Sprint: [Shift]=Sprinter : [Maj]
Start game : [E]=Lancer la partie : [E]
Start ship : [E]=Démarrer le vaisseau : [E]
Store item : [E]=Stocker l'objet : [E]
Swing sign : [LMB]=Frapper : [Clic gauche]
Switch TV: [E]=Allumer/Éteindre la télé : [E]
Switch camera : [E]=Changer de caméra : [E]
Switch lights : [E]=Allumer/Éteindre la lumière : [E]
Switch water: [E]=Utiliser le robinet : [E]
Toggle laser : [LMB]=Allumer le laser : [Clic gauche]
Turn on/off : [E]=Allumer/Éteindre : [E]
Use airhorn : [LMB]=Klaxonner : [Clic gauche]
Use cash register : [LMB]=Utiliser la caisse : [Clic gauche]
Use door : [E]=Utiliser la porte : [E]
Use key : [LMB]=Utiliser la clé : [Clic gauche]
Use ladder : [E]=Utiliser l'échelle : [E]
Use remote : [LMB]=Utiliser télécommande : [Clic gauche]
Use horn : [LMB]=Klaxonner : [Clic gauche]
Use hairdryer : [LMB]=Utiliser sèche-cheveux [Clic gauche]
Pull pin : [LMB]=Tirer la goupille : [Clic gauche]

[ Not holding items ]=[Rien en main]
[Pulling valve]=[En train de tourner une vanne]
[Cannot pull valve]=[Impossible de tourner la vanne]
(Cannot hold until ship has landed)=(Impossible en orbite)
[Hands full]=[Mains pleines]
[Nothing to store]=[Rien à conserver]
[Pulling cord]=[En train de tirer la corde]
Locked=Porte verouillée
