[Close]=Fermer
[Apply]=Appliquer

LethalConfig=LethalConfig
BadAssCompany=BadAssCompany
Custom Emotes API=Custom Emotes API
FacilityMeltdown=FacilityMeltdown
HerobrineMod=HerobrineMod
Scarlet Mansion=Scarlet Mansion
Accurate Stamina Display=Accurate Stamina Display
Backrooms=Backrooms
CoilHeadStare=CoilHeadStare
Coroner=Coroner
CullFactory=CullFactory
DiscountAlert=DiscountAlert
Diversity=Diversité
Drama Mask=Drama Mask
Drone Enemy=Drone Enemy
EmployeeAssignments=EmployeeAssignments
FreddyKrueger=FreddyKrueger
GeneralImprovements=GeneralImprovements
GiantSpecimens=GiantSpecimens
LC Sound Tool=LC Sound Tool
LCOffice=LCOffice
Lethal Company Input Utils=Lethal Company Input Utils
LethalCompanyHarpGhost=LethalCompanyHarpGhost
LethalExpansion(core)=LethalExpansion(core)
LethalLib=LethalLib
LethalThings=LethalThings
loaforcsSoundAPI=loaforcsSoundAPI
MaskedEnemyRework=MaskedEnemyRework
Mimics=Mimics
MirrorDecor=MiroirDécor
More Suits=More Suits
MoreBlood=MoreBlood
MoreEmotes-Sligili=PlusEmotes-Sligili
Needy Cats=Needy Cats
NightmareFoxy=NightmareFoxy
OpenBodyCams=OpenBodyCams
Peepers=Peepers
PizzaTowerEscapeMusic=PizzaTowerEscapeMusique
Rolling Giant=Rolling Giant
Scoopy's Variety Mod=Scoopy's Variety Mod
Scopophobia=Scopophobie
SCPCBDunGen=SCPCBDunGen
SecretLabs=SecretLabs
Ship Window=Ship Window
SignalTranslatorUpgrade=SignalTranslatorUpgrade
SirenHead=SirenHead
Skinwalker Mod=Skinwalker Mod
SkullEnemy=SkullEnemy
SlendermanMod=SlendermanMod
TakeTheMaskOff=TakeTheMaskOff
Terminal Api=Terminal Api
Too Many Suits=Too Many Suits
XUnity Resource Redirector=XUnity Resource Redirector